#####...s...######
#####.......######
#####.......######
..................
..................
..................
..................