############
#.......####
#....s..g###
#..........#
#..........#
#..........#
#....b.....#
#..........#
#..........#
#..........#
#..........#
############