50 50
dlllllllllllllllnlllllllllllllllllllnlllllllllllll
d000000000000u11d0000000000000000u11d000000000000u
d000000000000u11d0000000000000000u11d000000000000u
d000000000000u11d0000000000000000u11d000000000000u
d000000000000u11d0000000000000000u11d000000000000u
d000000000000u11d0000000000000000u11d000000000000u
d000000000000u11d0000000000000000u11d000000000000u
d000000000000u11d0000000000000000u11d000000000000u
d000000000000u11d0000000000000000u11d000000000000u
d000000000000u11d0000000000000000u11d000000000000u
d000000000000u11d0000000000000000u11d000000000000u
d000000000000ulll0000000000000000ulll000000000000u
d000000000000000000000000000000000000000000000000u
d000000000000000000000000000000000000000000000000u
d000000000000000000000000000000000000000000000000u
mrrrrrrrrrrrrrd00000000000000000000rrrrrrrrrrrrrru
d1111111111111d00000000000000000000u1111111111111u
d1111111111111d00000000000000000000u1111111111111u
dllllllllllllll00000000000000000000ulllllllllllllo
d000000000000000000000000000000000000000000000000u
d000000000000000000000000000000000000000000000000u
d000000000000000000000000000000000000000000000000u
d000000000000000000000000000000000000000000000000u
d000000000000000000000000000000000000000000000000u
d000000000000000000000000000000000000000000000000u
d000000000000000000000000000000000000000000000000u
d000000000000000000000000000000000000000000000000u
d000000000000000000000000000000000000000000000000u
d000000000000000000000000000000000000000000000000u
d000000000000000000000000000000000000000000000000u
d000000000000000000000000000000000000000000000000u
mrrrrrrrrrrrrrd00000000000000000000rrrrrrrrrrrrrru
d1111111111111d00000000000000000000u1111111111111u
d1111111111111d00000000000000000000u1111111111111u
dllllllllllllll00000000000000000000ulllllllllllllo
d000000000000000000000000000000000000000000000000u
d000000000000000000000000000000000000000000000000u
d000000000000000000000000000000000000000000000000u
d000000000000rrrd0000000000000000rrrd000000000000u
d000000000000u11d0000000000000000u11d000000000000u
d000000000000u11d0000000000000000u11d000000000000u
d000000000000u11d0000000000000000u11d000000000000u
d000000000000u11d0000000000000000u11d000000000000u
d000000000000u11d0000000000000000u11d000000000000u
d000000000000u11d0000000000000000u11d000000000000u
d000000000000u11d0000000000000000u11d000000000000u
d000000000000u11d0000000000000000u11d000000000000u
d000000000000u11d0000000000000000u11d000000000000u
d000000000000u11d0000000000000000u11d000000000000u
rrrrrrrrrrrrrprrrrrrrrrrrrrrrrrrrprrrrrrrrrrrrrrru