7 8
.o.....G
.......G
.......G
S.....oG
.......G
.......G
.......G
