7 8
.o.....G
.......G
...o...G
S......G
.......G
.......G
..o....G
