11 12
...........G
.........o.G
.o.o.o.....G
o..........G
...........G
S..........G
..o........G
o..oo....o.G
...........G
......o....G
...........G
