7 8
.......G
.......G
...o...G
S......G
.......G
.......G
.......G
