11
...........
.........o.
.o.o.o.....
o..........
...........
S..........
..o........
o..oo....o.
...........
......o....
...........
